"filename", "language", "JavaScript", "CSS", "HTML", "comment", "blank", "total"
"c:\Users\Adam\workspace\js-games-with-son\canvas.js", "JavaScript", 6, 0, 0, 0, 2, 8
"c:\Users\Adam\workspace\js-games-with-son\cell.js", "JavaScript", 41, 0, 0, 0, 10, 51
"c:\Users\Adam\workspace\js-games-with-son\componentFactory.js", "JavaScript", 34, 0, 0, 0, 7, 41
"c:\Users\Adam\workspace\js-games-with-son\context.js", "JavaScript", 2, 0, 0, 0, 4, 6
"c:\Users\Adam\workspace\js-games-with-son\effects\explosion.js", "JavaScript", 34, 0, 0, 0, 4, 38
"c:\Users\Adam\workspace\js-games-with-son\effects\particle.js", "JavaScript", 40, 0, 0, 0, 4, 44
"c:\Users\Adam\workspace\js-games-with-son\enemies\effectsOnEnemies\effectOnEnemy.js", "JavaScript", 34, 0, 0, 0, 8, 42
"c:\Users\Adam\workspace\js-games-with-son\enemies\effectsOnEnemies\frozenEffectOnEnemy.js", "JavaScript", 18, 0, 0, 0, 5, 23
"c:\Users\Adam\workspace\js-games-with-son\enemies\enemy.js", "JavaScript", 87, 0, 0, 0, 14, 101
"c:\Users\Adam\workspace\js-games-with-son\enemies\wave.js", "JavaScript", 36, 0, 0, 1, 7, 44
"c:\Users\Adam\workspace\js-games-with-son\enemies\waves.data.js", "JavaScript", 52, 0, 0, 1, 1, 54
"c:\Users\Adam\workspace\js-games-with-son\gameHanlders.js", "JavaScript", 82, 0, 0, 0, 10, 92
"c:\Users\Adam\workspace\js-games-with-son\gameUtils.js", "JavaScript", 10, 0, 0, 0, 3, 13
"c:\Users\Adam\workspace\js-games-with-son\index.html", "HTML", 0, 0, 47, 2, 1, 50
"c:\Users\Adam\workspace\js-games-with-son\projectiles\new\drawers\arrowDrawer.js", "JavaScript", 11, 0, 0, 0, 4, 15
"c:\Users\Adam\workspace\js-games-with-son\projectiles\new\drawers\frozenShardDrawer.js", "JavaScript", 18, 0, 0, 0, 4, 22
"c:\Users\Adam\workspace\js-games-with-son\projectiles\new\drawers\projectileDrawer.js", "JavaScript", 12, 0, 0, 0, 5, 17
"c:\Users\Adam\workspace\js-games-with-son\projectiles\new\drawers\rocketDrawer.js", "JavaScript", 18, 0, 0, 0, 4, 22
"c:\Users\Adam\workspace\js-games-with-son\projectiles\new\effects\explosionEffect.js", "JavaScript", 14, 0, 0, 0, 6, 20
"c:\Users\Adam\workspace\js-games-with-son\projectiles\new\effects\frozenNovaEffect.js", "JavaScript", 14, 0, 0, 0, 6, 20
"c:\Users\Adam\workspace\js-games-with-son\projectiles\new\effects\normalHitEffect.js", "JavaScript", 5, 0, 0, 0, 2, 7
"c:\Users\Adam\workspace\js-games-with-son\projectiles\new\effects\projectileEffect.js", "JavaScript", 5, 0, 0, 0, 2, 7
"c:\Users\Adam\workspace\js-games-with-son\projectiles\new\factories\arrowFactory.js", "JavaScript", 13, 0, 0, 0, 4, 17
"c:\Users\Adam\workspace\js-games-with-son\projectiles\new\factories\frozenShardFactory.js", "JavaScript", 14, 0, 0, 0, 4, 18
"c:\Users\Adam\workspace\js-games-with-son\projectiles\new\factories\projectileFactory.js", "JavaScript", 19, 0, 0, 0, 5, 24
"c:\Users\Adam\workspace\js-games-with-son\projectiles\new\factories\rocketFactory.js", "JavaScript", 13, 0, 0, 0, 4, 17
"c:\Users\Adam\workspace\js-games-with-son\projectiles\new\physics\defaultProjectilePhysic.js", "JavaScript", 17, 0, 0, 0, 3, 20
"c:\Users\Adam\workspace\js-games-with-son\projectiles\new\projectile.js", "JavaScript", 42, 0, 0, 0, 4, 46
"c:\Users\Adam\workspace\js-games-with-son\projectiles\new\projectileType.js", "JavaScript", 4, 0, 0, 0, 0, 4
"c:\Users\Adam\workspace\js-games-with-son\src.js", "JavaScript", 111, 0, 0, 5, 27, 143
"c:\Users\Adam\workspace\js-games-with-son\state\state.js", "JavaScript", 12, 0, 0, 0, 5, 17
"c:\Users\Adam\workspace\js-games-with-son\state\stateManager.js", "JavaScript", 121, 0, 0, 1, 15, 137
"c:\Users\Adam\workspace\js-games-with-son\style.css", "CSS", 0, 21, 0, 2, 3, 26
"c:\Users\Adam\workspace\js-games-with-son\towers\FrostTower.js", "JavaScript", 23, 0, 0, 0, 5, 28
"c:\Users\Adam\workspace\js-games-with-son\towers\archerTower.js", "JavaScript", 19, 0, 0, 0, 6, 25
"c:\Users\Adam\workspace\js-games-with-son\towers\rocketTower.js", "JavaScript", 21, 0, 0, 0, 5, 26
"c:\Users\Adam\workspace\js-games-with-son\towers\tower.js", "JavaScript", 66, 0, 0, 2, 11, 79
"c:\Users\Adam\workspace\js-games-with-son\towers\towerDrawer.js", "JavaScript", 37, 0, 0, 0, 7, 44
"c:\Users\Adam\workspace\js-games-with-son\towers\towers.cfg.js", "JavaScript", 26, 0, 0, 0, 3, 29
"c:\Users\Adam\workspace\js-games-with-son\ui\buildingMenu.js", "JavaScript", 28, 0, 0, 0, 8, 36
"c:\Users\Adam\workspace\js-games-with-son\ui\buildingMenuCell.js", "JavaScript", 61, 0, 0, 0, 8, 69
"c:\Users\Adam\workspace\js-games-with-son\ui\gameBar.js", "JavaScript", 17, 0, 0, 0, 2, 19
"Total", "-", 1237, 21, 47, 14, 242, 1561